5 5 5 5 5 5 5 5 5 0 0 0
3 3 5 5 5 5 5 5 5 5 0 0
3 3 3 5 5 3 3 5 5 5 0 0
3 3 3 5 3 3 3 3 5 5 5 5
3 3 5 5 3 3 3 3 5 5 5 5
3 5 5 5 3 3 3 3 5 4 5 5
5 5 5 5 5 3 3 5 4 4 5 5
4 2 2 2 5 3 3 5 4 4 4 5
4 4 2 2 0 3 5 2 4 4 4 5
4 4 2 0 0 5 5 2 2 4 2 5
4 4 4 0 0 0 5 2 2 2 0 0
4 4 4 0 0 0 0 2 2 2 2 0
